1 1 1 1 1 1 1 1 1 1
1 5 0 5 5 0 0 5 0 1
1 0 0 0 0 0 0 0 5 1
0 1 0 0 5 0 7 0 0 1
0 1 0 5 5 0 0 0 1 1
0 1 0 0 2 7 0 0 1 0
1 0 0 0 0 7 0 0 1 0
1 7 0 0 0 0 0 0 1 1
1 0 7 7 0 0 7 0 7 1
1 1 1 1 1 1 1 1 1 1
